++++++++++++++++++++++++++++++++++++++++++++++++
++++++++++++++++       ++++++++++             E+
++++++++++++++++ ++++++++++++++++ ++++++++++++++
S     ++++++++++ ++++++++++++++++ ++++++++++++++
+++++ ++++++         ++++++++++++     ++++++++++
+++++ ++++++ +++++++ ++++++++++++++++ ++++++++++
+++++ ++++++ +++++++ ++++++++++++++++ ++++++++++
+++++ ++++++ +++++++ +++          +++ ++++++++++
+++++        +++++++ +++++++ ++++ +++          +
++++++++++++++++++++ +++++++ +    +++ ++++++++++
++++++++++++++++++++ +++++++ ++++++++ ++++++++++
++++++++++++++++++++                  ++++++++++
++++++++++++++++++++++++++++++++++++++++++++++++