++++++++++++++++++++++++++++++++++++++++++++++++
++++++++               ++++++++++ +           E+
++++++++ +++++++ ++++++++++++++++ ++++++ +++++++
S     ++ +++++++ ++++++++++++++++ ++++++       +
+++++ ++ +++   +     ++++++++++++     ++++ +++ +
+++++ ++ +++ +++++++         ++++++++ ++++ +++++
+     ++ +++ +++++++++++++++ ++++++++ ++++    ++
+ +++ ++ +++ +++++++         ++++++++ +++++++ ++
+            +++++++++++++++ ++++ +++          +
+++++++++++ +++     ++++++++ ++++ +++ ++++++++++
+++++++++++ +++ ++++++++++++ ++++ +++ ++++++++++
++++++          ++++                  ++++++++++
++++++++++++++++++++++++++++++++++++++++++++++++